21 11 31 22 11 31 51 52 21        0    0    0    0    0    0    0    0        1
21 11 33 42 11 51 33 52 21        0    0    0    1    0    0    2    0        4
21 11 22 51 52 12 22 33 21        0    0    0    1    1    0    2    2        8
21 11 22 31 43 51 13 22 11        0    0    0    1    1    1    2    1        8
21 11 52 11 21 31 52 41 51        0    0    0    1    2    2    0    1        8
21 11 22 12 52 12 52 31 41        0    0    0    2    0    1    2    1        8
11 21 33 23 11 32 51 52 23        0    0    1    0    0    0    2    0        4
11 21 33 23 11 32 51 52 21        0    0    1    0    2    0    0    0        4
11 42 31 21 13 42 33 41 51        0    0    1    1    0    0    2    2        2
21 11 21 33 42 11 23 12 43        0    0    1    1    0    1    0    0        8
21 11 22 31 41 11 32 42 13        0    0    1    1    1    0    1    2        8
21 11 31 21 51 31 21 41 11        0    0    1    1    2    2    0    0        2
21 11 22 32 41 51 13 22 11        0    0    1    1    2    2    2    1        8
21 11 21 41 11 23 41 11 43        0    0    1    2    0    0    0    0        8
21 11 41 51 41 12 42 11 41        0    0    1    2    0    0    1    2        4
21 11 42 12 41 52 41 11 41        0    0    1    2    0    0    2    1        4
21 11 21 32 42 11 23 12 43        0    0    1    2    0    1    0    2        8
21 11 22 12 22 51 31 52 21        0    0    1    2    1    0    0    2        8
21 11 21 12 23 42 11 43 12        0    0    1    2    1    0    1    1        8
21 11 22 13 21 31 21 11 41        0    0    1    2    1    1    0    1        8
21 11 21 41 11 23 43 11 43        0    0    1    2    2    1    0    0        4
21 11 22 11 52 33 51 21 51        0    0    2    0    0    0    0    1        4
21 11 22 11 22 52 33 51 23        0    0    2    0    0    0    1    0        4
21 11 22 11 52 33 51 21 12        0    0    2    0    0    1    0    0        4
21 11 22 11 22 52 33 51 21        0    0    2    0    1    0    0    0        4
21 11 33 42 11 21 12 31 43        0    0    2    1    1    0    0    2        8
21 11 22 13 21 13 21 12 43        0    0    2    1    1    1    2    2        8
21 11 21 11 52 11 23 11 43        0    0    2    2    0    0    1    1        2
21 11 22 11 32 52 33 51 23        0    0    2    2    0    0    2    0        8
21 11 23 11 33 51 21 12 43        0    0    2    2    2    0    0    0        8
21 11 51 31 23 52 12 21 33        0    1    0    0    0    2    1    2        8
21 11 22 51 52 12 22 33 23        0    1    0    0    2    0    1    2        8
21 11 52 11 21 31 52 41 12        0    1    0    0    2    1    0    2        8
21 11 32 43 12 31 43 51 31        0    1    0    0    2    2    2    2        8
21 11 21 43 11 31 21 51 31        0    1    0    1    2    0    1    1        8
21 12 22 51 52 31 22 32 21        0    1    0    1    2    0    2    0        2
11 23 41 31 41 11 33 52 21        0    1    0    1    2    2    0    0        8
21 11 22 12 51 31 52 21 12        0    1    0    2    0    0    1    2        8
21 11 32 51 43 52 33 23 12        0    1    0    2    0    2    0    1        4
11 22 11 51 41 11 52 23 51        0    1    0    2    1    0    2    0        4
21 11 42 51 41 11 33 23 33        0    1    0    2    2    1    2    1        8


21 11 51 33 41 33 21 51 11        0    1    0    2    2    2    0    2        8
11 22 51 43 11 33 21 42 11        0    1    1    0    0    2    0    2        8
12 22 51 52 31 22 32 21 31        0    1    1    0    2    0    0    2        2
21 11 21 43 11 31 21 51 33        0    1    1    0    2    0    1    1        8
21 11 22 31 41 13 22 13 22        0    1    1    0    2    1    0    1        8
21 11 51 43 31 21 42 51 11        0    1    1    0    2    1    2    2        8
21 11 21 33 51 41 11 21 51        0    1    1    1    1    0    1    1        8
11 21 11 43 33 43 51 13 23        0    1    1    1    1    0    2    0        8
11 22 12 21 32 51 52 31 21        0    1    1    1    2    0    2    2        4
21 11 21 12 42 31 23 11 43        0    1    1    2    0    0    1    1        8
21 11 32 23 11 51 52 21 51        0    1    1    2    0    2    0    0        8
21 11 21 42 12 23 11 43 12        0    1    1    2    1    0    1    0        8
21 11 21 12 32 23 42 11 43        0    1    1    2    2    1    1    1        8
21 11 21 11 43 31 51 33 21        0    1    2    1    0    1    1    0        8
21 11 22 11 21 52 33 51 23        0    1    2    1    0    2    1    2        4
21 11 21 11 43 31 51 33 23        0    1    2    1    1    1    0    1        8
21 11 22 11 21 52 33 51 21        0    1    2    1    1    2    0    2        4
21 11 23 31 23 43 13 22 13        0    1    2    1    2    0    2    1        4
21 11 22 31 52 23 52 13 41        0    1    2    1    2    2    0    1        8
21 11 21 11 33 21 42 32 41        0    1    2    2    0    1    0    0        8
21 11 21 42 31 23 13 41 12        0    1    2    2    2    1    1    0        8
21 11 32 22 11 51 52 21 51        0    2    0    1    0    0    0    0        8
21 11 21 12 51 43 31 23 51        0    2    0    1    0    1    1    1        8
11 22 11 51 41 11 52 21 12        0    2    0    1    0    2    0    1        4
21 11 31 51 43 52 33 21 51        0    2    0    1    1    0    2    0        4
21 11 32 41 11 31 51 23 31        0    2    0    1    2    1    0    0        8
21 11 51 52 22 41 12 33 21        0    2    0    2    0    2    0    0        8
21 11 21 12 23 11 22 41 51        0    2    0    2    1    0    0    1        8
21 11 32 21 31 42 13 31 41        0    2    0    2    2    0    0    0        8
21 11 21 51 41 11 23 51 12        0    2    0    0    0    1    1    1        8
21 11 32 23 13 33 42 33 41        0    2    1    0    2    0    1    0        8
21 11 32 41 11 31 51 23 33        0    2    1    0    2    1    0    0        8
21 11 21 32 51 41 11 21 51        0    2    1    1    0    0    1    1        8
21 11 21 11 52 31 23 12 43        0    2    1    1    0    1    1    0        8
21 11 31 21 13 42 33 43 51        0    2    1    1    1    0    2    2        4
21 11 21 12 31 23 11 22 43        0    2    1    1    1    1    0    0        8
21 11 21 12 21 41 11 22 13        0    2    1    1    1    1    2    1        8
21 11 23 31 23 41 13 22 13        0    2    1    1    2    0    2    1        8
21 11 23 33 23 41 13 22 13        0    2    1    1    2    1    2    0        8
11 21 11 31 51 11 41 13 21        0    2    1    1    2    2    0    1        4
21 11 51 31 21 41 51 11 22        0    2    1    1    2    2    2    2        8
21 11 21 11 31 52 23 12 43        0    2    1    2    0    0    1    0        8
21 11 21 11 31 21 42 32 41        0    2    1    2    0    1    0    0        8
21 11 21 31 22 11 21 12 43        0    2    1    2    0    1    1    2        8
21 11 21 51 13 21 51 41 51        0    2    1    2    1    0    1    2        4
21 11 21 42 13 43 13 23 13        0    2    1    2    2    0    2    0        8
21 11 21 12 23 11 41 12 32        0    2    2    0    0    0    1    1        8
21 11 22 11 32 52 33 51 21        0    2    2    0    2    0    0    0        8
21 11 21 33 21 32 22 13 41        0    2    2    1    0    1    1    2        4
21 11 21 42 32 23 13 41 12        0    2    2    1    2    1    1    0        4
21 11 21 11 23 32 51 52 21        0    2    2    2    0    0    0    0        8
21 11 21 11 33 52 23 12 43        0    2    2    2    2    0    1    0        8
21 11 33 42 13 51 31 51 41        1    0    0    0    0    0    0    2        4
21 11 22 42 13 22 11 22 41        1    0    0    0    2    1    1    1        8
21 11 21 33 42 11 23 12 41        1    0    0    1    0    0    0    1        8
21 11 22 11 42 11 51 52 21        1    0    0    1    0    0    1    0        8
11 21 31 21 12 51 31 52 21        1    0    0    1    0    0    2    2        8
21 11 22 42 12 51 31 52 21        1    0    0    1    1    0    1    2        8
11 22 11 32 51 41 11 52 21        1    0    0    1    2    0    0    2        2
21 11 21 41 11 31 21 51 31        1    0    0    1    2    0    1    1        8
21 11 21 41 11 23 41 11 41        1    0    0    2    0    0    0    0        8
21 11 42 12 41 52 41 11 43        1    0    0    2    0    1    2    0        4
21 11 21 32 42 11 23 12 41        1    0    0    2    0    2    0    1        8
21 11 41 51 41 12 42 11 43        1    0    0    2    0    2    1    0        4
21 11 51 33 43 32 23 52 31        1    0    0    2    0    2    2    2        8
21 11 21 32 21 52 31 52 43        1    0    0    2    1    0    1    1        8


21 11 21 41 11 23 43 11 41        1    0    0    2    2    0    0    1        4
21 11 23 11 51 32 21 12 41        1    0    0    2    2    0    1    0        8
21 11 32 51 22 41 51 11 21        1    0    1    0    1    0    0    0        8
21 11 22 31 43 11 32 42 13        1    0    1    0    1    0    1    2        8
21 11 51 43 31 21 42 51 13        1    0    1    0    1    2    2    2        8
21 11 21 41 11 31 21 51 33        1    0    1    0    2    0    1    1        8
21 11 42 31 21 13 42 33 41        1    0    1    0    2    0    2    0        2
21 11 21 12 31 51 43 31 21        1    0    1    1    1    1    1    0        8
21 11 21 31 41 33 21 52 33        1    0    1    1    1    2    1    2        8
21 11 21 31 41 33 21 52 31        1    0    1    1    1    2    2    1        8
21 11 23 32 41 33 23 52 31        1    0    1    1    2    0    2    2        4
21 11 21 12 41 31 21 51 31        1    0    1    1    2    1    1    2        8
21 11 21 12 41 31 21 51 33        1    0    1    1    2    1    2    1        8
21 11 41 11 41 52 11 52 43        1    0    1    2    0    0    0    2        8
21 11 21 12 22 32 21 11 41        1    0    1    2    0    0    1    1        8
21 11 21 12 22 32 21 11 43        1    0    1    2    0    1    1    0        8
21 11 32 23 11 51 52 23 51        1    0    1    2    0    2    0    0        8
21 11 21 12 31 23 11 43 12        1    0    1    2    1    0    1    0        8
21 11 21 33 23 42 13 43 51        1    0    1    2    2    1    1    1        8
21 11 51 33 43 32 23 52 33        1    0    2    0    0    2    2    2        8
21 11 32 23 11 22 51 52 23        1    0    2    1    0    0    0    2        8
21 11 21 42 12 33 23 11 43        1    0    2    1    0    1    1    0        8
21 11 23 31 23 43 13 22 11        1    0    2    1    0    2    2    1        4
21 11 21 12 33 23 11 43 12        1    0    2    1    1    0    1    0        8
21 11 22 51 21 51 42 13 41        1    0    2    1    2    2    1    0        8
21 11 21 11 23 13 42 13 41        1    0    2    2    0    0    0    1        8
21 11 21 12 22 33 21 11 43        1    0    2    2    0    0    1    0        8
21 11 21 12 22 31 21 11 43        1    0    2    2    0    1    0    0        8
21 11 21 42 13 41 13 23 11        1    0    2    2    0    2    1    1        4
21 11 21 32 42 31 23 13 43        1    0    2    2    1    0    1    2        8
21 11 21 42 32 23 13 43 51        1    0    2    2    2    0    1    1        4
21 11 21 43 11 23 43 11 41        1    0    2    2    2    1    0    1        8
21 11 22 12 52 43 13 51 21        1    0    2    2    2    2    0    0        8
21 11 22 11 42 11 51 52 23        1    1    0    0    1    0    0    0        8
21 11 21 51 21 31 43 52 33        1    1    0    0    1    0    1    2        8
21 11 21 51 21 31 43 52 31        1    1    0    0    1    0    2    1        8
21 11 22 31 43 13 22 13 51        1    1    0    0    1    1    2    0        8
21 11 23 43 52 11 21 52 11        1    1    0    0    2    2    2    1        8
11 21 33 41 11 23 41 11 41        1    1    0    1    0    0    0    0        8
21 11 23 12 41 31 23 51 31        1    1    0    1    0    0    1    2        8
21 11 23 12 43 31 23 51 31        1    1    0    1    0    1    0    2        8
11 22 31 21 43 33 23 52 31        1    1    0    1    2    0    2    2        4
21 11 21 12 42 31 23 11 41        1    1    0    2    0    1    1    0        8
21 11 21 12 33 23 11 41 51        1    1    0    2    1    0    1    0        8
21 11 23 43 31 23 12 51 31        1    1    1    0    0    0    1    2        8
21 11 21 33 51 41 11 21 12        1    1    1    0    0    1    1    1        8
21 11 23 12 43 31 23 51 33        1    1    1    0    0    1    2    0        8
21 11 42 32 23 11 51 52 21        1    1    1    0    0    2    1    0        8
21 11 21 12 31 51 43 31 23        1    1    1    0    1    1    1    0        8
21 11 22 41 51 13 22 13 51        1    1    1    0    1    1    2    2        8
21 11 32 51 23 33 43 52 31        1    1    1    0    1    2    0    0        8
11 22 31 21 43 33 23 52 33        1    1    1    0    2    0    2    2        4
21 11 22 41 51 13 22 11 22        1    1    1    0    2    2    1    1        8
21 11 21 31 51 32 41 11 21        1    1    1    1    0    0    1    1        4
21 11 31 41 13 23 51 23 13        1    1    1    1    0    2    1    2        8
21 11 21 31 51 32 41 11 23        1    1    1    1    1    0    0    1        4
21 11 21 32 51 31 41 11 21        1    1    1    1    1    0    1    0        4
21 11 31 41 13 23 51 23 11        1    1    1    1    2    0    1    2        8
21 11 21 12 43 31 21 51 31        1    1    1    1    2    1    1    1        8
21 11 33 51 12 21 41 52 11        1    1    1    1    2    2    2    2        1
21 11 21 11 51 13 41 11 23        1    1    1    2    0    0    0    1        8
21 11 22 33 43 11 32 42 13        1    1    1    2    1    0    1    2        8
21 11 21 43 33 22 52 23 33        1    1    1    2    1    2    0    1        8
21 11 22 12 21 51 52 31 21        1    1    1    2    1    2    2    2        4
21 11 31 21 41 13 22 51 13        1    1    1    2    2    1    2    2        4
21 11 32 23 11 22 51 52 21        1    1    2    0    0    0    0    2        8


11 21 33 22 43 33 52 23 31        1    1    2    0    2    0    0    0        8
21 11 21 13 23 33 21 31 41        1    1    2    1    0    0    0    1        8
21 11 21 43 33 22 52 23 31        1    1    2    1    1    2    1    0        8
21 11 22 33 43 13 22 13 22        1    1    2    1    2    1    0    1        8
21 11 22 12 23 11 22 11 43        1    1    2    2    1    1    2    2        2
21 11 22 42 52 23 52 13 41        1    1    2    2    2    0    0    1        8
21 11 33 21 13 42 31 22 41        1    1    2    2    2    2    1    1        2
21 11 22 12 42 52 13 51 21        1    2    0    0    1    0    0    2        8
21 11 22 13 41 51 41 33 43        1    2    0    0    1    1    2    2        8
21 11 32 23 13 33 42 33 43        1    2    0    0    2    0    1    0        8
21 11 21 11 52 31 23 12 41        1    2    0    1    0    0    1    1        8
21 11 21 12 31 23 11 22 41        1    2    0    1    1    0    0    1        8
21 11 22 42 12 51 52 31 21        1    2    0    1    1    0    2    2        8
21 11 41 13 52 21 42 33 21        1    2    0    1    2    1    2    0        8
21 11 21 11 31 52 23 12 41        1    2    0    2    0    0    1    0        8
21 11 21 31 22 11 21 12 41        1    2    0    2    0    2    1    1        8
21 11 32 23 11 51 52 21 12        1    2    1    0    2    0    0    0        8
21 11 22 51 43 11 21 42 13        1    2    1    0    2    0    1    2        8
21 11 21 11 51 13 41 11 21        1    2    1    1    0    0    0    1        8
21 11 22 43 12 52 11 22 13        1    2    1    1    1    0    2    1        8
21 11 21 32 21 41 13 22 13        1    2    1    1    1    1    2    0        8
21 11 21 41 52 43 12 31 41        1    2    1    1    1    2    0    1        8
21 11 23 32 41 33 52 23 33        1    2    1    1    2    0    0    2        8
21 11 23 32 41 33 52 23 31        1    2    1    1    2    0    2    0        8
21 11 21 41 31 21 12 51 33        1    2    1    1    2    1    0    1        8
21 11 21 41 31 21 12 51 31        1    2    1    1    2    1    1    0        8
21 11 32 21 42 13 22 13 43        1    2    1    1    2    1    2    2        4
21 11 21 13 31 43 11 23 13        1    2    1    2    1    1    1    0        8
21 11 22 43 33 21 52 23 33        1    2    1    2    1    2    0    0        8
21 11 21 33 43 33 21 52 33        1    2    1    2    1    2    1    2        2
21 11 21 11 51 21 11 41 11        1    2    1    2    2    0    0    1        8
21 11 21 11 33 23 12 43 51        1    2    2    0    0    1    0    0        8
21 11 32 23 43 33 52 21 33        1    2    2    0    0    2    0    2        8
21 11 22 12 52 43 13 51 23        1    2    2    0    0    2    2    0        8
21 11 51 21 12 22 51 33 43        1    2    2    1    0    0    0    0        4
21 11 21 13 33 43 13 23 13        1    2    2    1    1    0    2    0        8
21 11 21 12 21 11 22 13 43        1    2    2    1    1    1    0    1        8
21 11 21 13 33 43 11 23 13        1    2    2    1    1    1    1    0        8
21 11 21 33 43 33 21 52 31        1    2    2    1    1    2    2    1        2
21 11 21 13 21 41 11 21 13        1    2    2    1    2    0    0    1        8
21 11 21 13 21 43 11 21 13        1    2    2    1    2    1    0    0        8
21 11 21 33 22 32 21 13 41        1    2    2    1    2    2    1    1        8
21 11 21 11 22 31 21 12 41        1    2    2    2    0    0    1    1        8
21 11 21 11 21 31 22 12 41        1    2    2    2    0    1    0    1        8
21 11 21 12 51 33 23 51 43        1    2    2    2    0    1    1    0        8
21 11 21 32 21 33 22 13 41        1    2    2    2    0    2    1    2        8
21 11 21 13 32 41 11 23 13        1    2    2    2    1    0    1    0        8
21 11 21 12 51 32 43 33 21        1    2    2    2    1    1    1    2        4
21 11 21 31 22 32 21 13 41        1    2    2    2    1    2    1    1        4
21 11 32 23 12 52 13 51 21        2    0    0    0    0    2    0    2        8
21 11 21 12 42 33 23 11 41        2    0    0    1    0    1    1    1        8
21 11 32 21 12 52 13 51 23        2    0    0    1    0    2    2    2        8
21 11 22 13 21 13 21 12 41        2    0    0    1    1    2    2    1        8
21 11 22 11 51 41 11 52 21        2    0    0    1    2    0    0    1        4
21 11 22 12 51 31 52 21 51        2    0    0    1    2    0    1    0        8
21 11 22 42 51 21 51 13 41        2    0    0    1    2    2    1    1        8
21 11 22 11 52 11 23 11 41        2    0    0    2    0    1    1    0        2
21 11 22 51 12 41 13 52 23        2    0    0    2    1    0    0    1        2
21 11 23 11 33 51 21 12 41        2    0    0    2    2    0    0    0        8
21 11 21 12 23 42 11 43 51        2    0    1    0    1    1    1    0        8
21 11 22 32 42 13 22 11 43        2    0    1    0    1    1    2    2        8
21 11 23 31 23 41 13 22 11        2    0    1    1    0    2    2    1        8
21 11 21 41 51 33 21 52 31        2    0    1    1    1    0    1    0        8
21 11 21 41 51 21 13 22 11        2    0    1    1    1    0    2    2        4
21 11 21 12 21 41 11 22 11        2    0    1    1    1    1    2    1        8
21 11 22 51 21 51 42 13 43        2    0    1    1    2    0    1    2        8

21 11 23 31 41 33 23 52 31        2    0    1    1    2    0    2    1        8
11 21 12 22 12 31 21 13 41        2    0    1    1    2    2    0    1        4
21 11 21 12 22 33 21 11 41        2    0    1    2    0    0    1    0        8
21 11 22 12 23 51 31 52 21        2    0    1    2    0    0    2    2        8
21 11 21 11 23 13 42 13 43        2    0    1    2    0    1    0    0        8
21 11 21 51 11 51 23 12 43        2    0    1    2    0    1    1    2        4
21 11 21 42 13 43 13 23 11        2    0    1    2    0    2    2    0        8
21 11 21 32 42 31 23 13 41        2    0    1    2    1    2    1    0        8
21 11 21 42 31 23 13 43 51        2    0    1    2    2    0    1    1        8
21 11 22 11 21 42 13 32 43        2    0    1    2    2    0    2    0        8
21 11 21 43 11 23 43 11 43        2    0    1    2    2    1    0    1        8
21 11 22 33 22 42 13 43 51        2    0    1    2    2    1    1    0        4
21 12 21 43 52 21 12 32 41        2    0    2    0    0    1    0    1        2
21 11 22 42 11 52 33 51 21        2    0    2    0    1    0    1    0        2
21 11 21 12 22 13 21 12 43        2    0    2    1    0    1    1    2        8
21 11 21 12 22 13 21 12 41        2    0    2    1    0    2    1    1        8
21 11 21 12 21 43 11 22 11        2    0    2    1    1    1    1    1        8
21 11 23 33 42 51 21 13 41        2    0    2    1    2    1    0    1        4
21 11 21 12 21 32 22 11 41        2    0    2    2    0    0    1    2        8
21 11 21 12 21 32 22 11 43        2    0    2    2    0    2    1    0        8
21 11 22 11 51 41 11 52 23        2    1    0    0    0    0    2    1        4
21 11 32 21 12 52 13 51 21        2    1    0    0    2    2    0    2        8
21 11 21 12 31 23 11 41 51        2    1    0    1    1    0    1    0        8
21 11 51 23 51 43 13 22 13        2    1    0    1    2    0    2    1        4
21 11 22 31 52 23 52 13 43        2    1    0    1    2    1    0    2        8
21 11 21 11 31 23 12 41 12        2    1    0    2    0    0    0    1        8
21 11 21 32 21 13 22 11 41        2    1    0    2    1    1    2    0        8
21 11 22 51 43 11 21 42 11        2    1    1    0    0    2    1    2        8
21 11 31 21 13 42 33 43 12        2    1    1    0    0    2    2    1        4
21 11 31 21 13 42 33 41 12        2    1    1    0    1    2    2    0        4
21 11 22 32 41 13 22 11 22        2    1    1    0    2    0    1    2        4
21 11 21 11 22 11 21 11 41        2    1    1    1    0    0    0    1        8
21 11 21 32 21 41 13 22 11        2    1    1    1    1    1    2    0        8
11 22 31 21 12 31 21 11 41        2    1    1    1    2    1    2    2        4
21 11 21 11 51 21 11 41 13        2    1    1    2    0    2    0    1        8
21 11 22 12 23 11 22 11 41        2    1    1    2    1    2    2    1        2
21 11 22 42 52 23 52 13 43        2    1    1    2    2    1    0    0        8
21 11 21 42 32 23 13 22 43        2    1    2    0    1    0    1    2        4
21 11 21 42 32 23 13 22 41        2    1    2    0    1    2    1    0        4
21 11 31 21 11 31 51 52 21        2    1    2    1    0    0    0    0        4
21 11 21 13 33 43 13 23 11        2    1    2    1    0    1    2    0        8
21 11 21 13 21 41 11 21 11        2    1    2    1    0    2    0    1        8
21 11 21 13 33 43 11 23 11        2    1    2    1    1    1    1    0        8
21 11 21 13 21 43 11 21 11        2    1    2    1    1    2    0    0        8
21 11 22 51 21 51 13 43 12        2    1    2    1    1    2    1    2        2
21 11 21 51 12 32 41 13 23        2    1    2    1    1    2    2    1        8
21 11 21 11 43 13 51 11 23        2    1    2    2    1    1    1    2        4
21 11 22 51 12 41 13 52 21        2    2    0    0    0    0    1    1        2
21 11 21 12 23 11 22 41 12        2    2    0    0    0    1    0    1        8
21 11 22 32 23 33 23 13 43        2    2    0    1    0    1    1    2        8
21 11 21 33 21 32 22 13 43        2    2    0    1    0    2    1    1        4
21 11 21 13 22 41 31 23 33        2    2    0    2    1    0    1    1        4
21 11 21 11 33 52 23 12 41        2    2    0    2    2    0    1    0        8
21 11 21 32 21 32 22 13 43        2    2    0    2    2    2    1    1        8
21 11 21 51 13 21 51 41 12        2    2    1    0    0    2    1    1        4
21 11 22 32 51 21 51 13 41        2    2    1    0    2    2    1    2        8
21 11 22 13 43 51 41 33 41        2    2    1    0    2    2    2    1        8
21 11 51 21 12 22 51 33 41        2    2    1    1    0    0    0    0        4
21 11 21 12 21 51 33 51 41        2    2    1    1    0    2    0    1        8
21 11 21 12 21 11 22 13 41        2    2    1    1    1    1    0    1        8
21 11 21 33 41 33 21 52 33        2    2    1    1    1    2    1    2        8
21 11 21 12 51 33 23 51 41        2    2    1    2    0    0    1    1        8
21 11 21 11 22 31 21 12 43        2    2    1    2    0    1    1    0        8
21 11 21 32 21 33 22 13 43        2    2    1    2    0    2    1    2        8
21 11 21 11 51 11 41 13 23        2    2    1    2    0    2    2    1        8
21 11 21 32 22 33 21 13 43        2    2    1    2    2    0    1    2        8


21 11 21 11 51 11 41 13 21        2    2    1    2    2    2    0    1        8
21 11 21 13 43 13 23 13 51        2    2    2    0    0    0    2    1        8
21 11 21 13 22 41 31 23 31        2    2    2    0    1    0    1    1        4
21 11 21 13 22 43 31 23 31        2    2    2    0    1    1    0    1        4
21 11 21 13 43 11 23 11 22        2    2    2    0    1    1    1    0        4
21 11 21 13 21 43 13 21 11        2    2    2    1    0    2    0    0        8
21 11 21 33 21 33 22 13 41        2    2    2    1    0    2    1    2        8
21 11 21 11 43 13 51 11 21        2    2    2    1    1    1    1    2        4
21 11 21 13 21 43 13 21 13        2    2    2    1    2    0    0    0        8
21 11 21 11 22 13 21 13 43        2    2    2    1    2    1    0    2        8
21 11 21 11 22 13 21 13 41        2    2    2    1    2    2    0    1        8
21 11 21 11 21 12 22 12 41        2    2    2    2    0    0    0    1        8
21 11 21 13 23 31 21 33 41        2    2    2    2    0    0    2    2        4
21 11 21 11 22 33 21 12 43        2    2    2    2    0    1    1    2        8
21 11 21 11 22 33 21 12 41        2    2    2    2    0    2    1    1        8
21 11 21 13 23 31 21 33 43        2    2    2    2    0    2    2    0        4
21 11 21 31 42 33 23 13 41        2    2    2    2    1    1    1    1        1
21 11 22 32 51 11 52 33 21        2    2    2    2    2    0    2    0        4
21 11 21 31 21 33 22 13 41        2    2    2    2    2    2    1    2        8